122 122 122 122 122 122 122 122 122 122 122 122 122 122 122 122 122 122 122 122 122 122 122 122 122 122 122 122 122 122 122 122 122 122 122 122 122 122 122 122 122 122 122 122 122 122 122 122 122 122 122 122 122 122 122 122 122 122 122 122
122 110 121 110 121 110 121 110 121 110 121 110 121 110 121 110 121 110 121 110 121 110 121 110 121 110 121 110 121 110 121 110 121 110 121 110 121 110 121 110 121 110 121 110 121 110 121 110 121 110 121 110 121 110 121 110 121 110 121 122
122 110 123 110 123 110 123 110 123 110 123 110 123 110 123 110 123 110 123 110 123 110 123 110 123 110 123 110 123 110 123 110 123 110 123 110 123 110 123 110 123 110 123 110 123 110 123 110 123 110 123 110 123 110 123 110 123 110 123 122
122 110 121 110 121 110 121 110 121 110 121 110 121 110 121 110 121 110 121 110 121 110 121 110 121 110 121 110 121 110 121 110 121 110 121 110 121 110 121 110 121 110 121 110 121 110 121 110 121 110 121 110 121 110 121 110 121 110 121 122
122 110 123 110 123 110 123 110 123 110 123 110 123 110 123 110 123 110 123 110 123 110 123 110 123 110 123 110 123 110 123 110 123 110 123 110 123 110 123 110 123 110 123 110 123 110 123 110 123 110 123 110 123 110 123 110 123 110 123 122
122 110 121 110 121 110 121 110 121 110 121 110 121 110 121 110 121 110 121 110 121 110 121 110 121 110 121 110 121 110 121 110 121 110 121 110 121 110 121 110 121 110 121 110 121 110 121 110 121 110 121 110 121 110 121 110 121 110 121 122
122 110 123 110 123 110 123 110 123 110 123 110 123 110 123 110 123 110 123 110 123 110 123 110 123 110 123 110 123 110 123 110 123 110 123 110 123 110 123 110 123 110 123 110 123 110 123 110 123 110 123 110 123 110 123 110 123 110 123 122
122 110 121 110 121 110 121 110 121 110 121 110 121 110 121 110 121 110 121 110 121 110 121 110 121 110 121 110 121 110 121 110 121 110 121 110 121 110 121 110 121 110 121 110 121 110 121 110 121 110 121 110 121 110 121 110 121 110 121 122
122 110 123 110 123 110 123 110 123 110 123 110 123 110 123 110 123 110 123 110 123 110 123 110 123 110 123 110 123 110 123 110 123 110 123 110 123 110 123 110 123 110 123 110 123 110 123 110 123 110 123 110 123 110 123 110 123 110 123 122
122 110 121 110 121 110 121 110 121 110 121 110 121 110 121 110 121 110 121 110 121 110 121 110 121 110 121 110 121 110 121 110 121 110 121 110 121 110 121 110 121 110 121 110 121 110 121 110 121 110 121 110 121 110 121 110 121 110 121 122
122 110 123 110 123 110 123 110 123 110 123 110 123 110 123 110 123 110 123 110 123 110 123 110 123 110 123 110 123 110 123 110 123 110 123 110 123 110 123 110 123 110 123 110 123 110 123 110 123 110 123 110 123 110 123 110 123 110 123 122
122 110 121 110 121 110 121 110 121 110 121 110 121 110 121 110 121 110 121 110 121 110 121 110 121 110 121 110 121 110 121 110 121 110 121 110 121 110 121 110 121 110 121 110 121 110 121 110 121 110 121 110 121 110 121 110 121 110 121 122
122 110 123 110 123 110 123 110 123 110 123 110 123 110 123 110 123 110 123 110 123 110 123 110 123 110 123 110 123 110 123 110 123 110 123 110 123 110 123 110 123 110 123 110 123 110 123 110 123 110 123 110 123 110 123 110 123 110 123 122
122 110 121 110 121 110 121 110 121 110 121 110 121 110 121 110 121 110 121 110 121 110 121 110 121 110 121 110 121 110 121 110 121 110 121 110 121 110 121 110 121 110 121 110 121 110 121 110 121 110 121 110 121 110 121 110 121 110 121 122
122 110 123 110 123 110 123 110 123 110 123 110 123 110 123 110 123 110 123 110 123 110 123 110 123 110 123 110 123 110 123 110 123 110 123 110 123 110 123 110 123 110 123 110 123 110 123 110 123 110 123 110 123 110 123 110 123 110 123 122
122 110 121 110 121 110 121 110 121 110 121 110 121 110 121 110 121 110 121 110 121 110 121 110 121 110 121 110 121 110 121 110 121 110 121 110 121 110 121 110 121 110 121 110 121 110 121 110 121 110 121 110 121 110 121 110 121 110 121 122
122 110 123 110 123 110 123 110 123 110 123 110 123 110 123 110 123 110 123 110 123 110 123 110 123 110 123 110 123 110 123 110 123 110 123 110 123 110 123 110 123 110 123 110 123 110 123 110 123 110 123 110 123 110 123 110 123 110 123 122
122 110 121 110 121 110 121 110 121 110 121 110 121 110 121 110 121 110 121 110 121 110 121 110 121 110 121 110 121 110 121 110 121 110 121 110 121 110 121 110 121 110 121 110 121 110 121 110 121 110 121 110 121 110 121 110 121 110 121 122
122 110 123 110 123 110 123 110 123 110 123 110 123 110 123 110 123 110 123 110 123 110 123 110 123 110 123 110 123 110 123 110 123 110 123 110 123 110 123 110 123 110 123 110 123 110 123 110 123 110 123 110 123 110 123 110 123 110 123 122
122 110 121 110 121 110 121 110 121 110 121 110 121 110 121 110 121 110 121 110 121 110 121 110 121 110 121 110 121 110 121 110 121 110 121 110 121 110 121 110 121 110 121 110 121 110 121 110 121 110 121 110 121 110 121 110 121 110 121 122
122 110 123 110 123 110 123 110 123 110 123 110 123 110 123 110 123 110 123 110 123 110 123 110 123 110 123 110 123 110 123 110 123 110 123 110 123 110 123 110 123 110 123 110 123 110 123 110 123 110 123 110 123 110 123 110 123 110 123 122
122 110 121 110 121 110 121 110 121 110 121 110 121 110 121 110 121 110 121 110 121 110 121 110 121 110 121 110 121 110 121 110 121 110 121 110 121 110 121 110 121 110 121 110 121 110 121 110 121 110 121 110 121 110 121 110 121 110 121 122
122 110 123 110 123 110 123 110 123 110 123 110 123 110 123 110 123 110 123 110 123 110 123 110 123 110 123 110 123 110 123 110 123 110 123 110 123 110 123 110 123 110 123 110 123 110 123 110 123 110 123 110 123 110 123 110 123 110 123 122
122 110 121 110 121 110 121 110 121 110 121 110 121 110 121 110 121 110 121 110 121 110 121 110 121 110 121 110 121 110 121 110 121 110 121 110 121 110 121 110 121 110 121 110 121 110 121 110 121 110 121 110 121 110 121 110 121 110 121 122
122 110 123 110 123 110 123 110 123 110 123 110 123 110 123 110 123 110 123 110 123 110 123 110 123 110 123 110 123 110 123 110 123 110 123 110 123 110 123 110 123 110 123 110 123 110 123 110 123 110 123 110 123 110 123 110 123 110 123 122
122 110 121 110 121 110 121 110 121 110 121 110 121 110 121 110 121 110 121 110 121 110 121 110 121 110 121 110 121 110 121 110 121 110 121 110 121 110 121 110 121 110 121 110 121 110 121 110 121 110 121 110 121 110 121 110 121 110 121 122
122 110 123 110 123 110 123 110 123 110 123 110 123 110 123 110 123 110 123 110 123 110 123 110 123 110 123 110 123 110 123 110 123 110 123 110 123 110 123 110 123 110 123 110 123 110 123 110 123 110 123 110 123 110 123 110 123 110 123 122
122 110 121 110 121 110 121 110 121 110 121 110 121 110 121 110 121 110 121 110 121 110 121 110 121 110 121 110 121 110 121 110 121 110 121 110 121 110 121 110 121 110 121 110 121 110 121 110 121 110 121 110 121 110 121 110 121 110 121 122
122 110 123 110 123 110 123 110 123 110 123 110 123 110 123 110 123 110 123 110 123 110 123 110 123 110 123 110 123 110 123 110 123 110 123 110 123 110 123 110 123 110 123 110 123 110 123 110 123 110 123 110 123 110 123 110 123 110 123 122
122 110 121 110 121 110 121 110 121 110 121 110 121 110 121 110 121 110 121 110 121 110 121 110 121 110 121 110 121 110 121 110 121 110 121 110 121 110 121 110 121 110 121 110 121 110 121 110 121 110 121 110 121 110 121 110 121 110 121 122
122 110 123 110 123 110 123 110 123 110 123 110 123 110 123 110 123 110 123 110 123 110 123 110 123 110 123 110 123 110 123 110 123 110 123 110 123 110 123 110 123 110 123 110 123 110 123 110 123 110 123 110 123 110 123 110 123 110 123 122
122 110 121 110 121 110 121 110 121 110 121 110 121 110 121 110 121 110 121 110 121 110 121 110 121 110 121 110 121 110 121 110 121 110 121 110 121 110 121 110 121 110 121 110 121 110 121 110 121 110 121 110 121 110 121 110 121 110 121 122
122 110 123 110 123 110 123 110 123 110 123 110 123 110 123 110 123 110 123 110 123 110 123 110 123 110 123 110 123 110 123 110 123 110 123 110 123 110 123 110 123 110 123 110 123 110 123 110 123 110 123 110 123 110 123 110 123 110 123 122
122 110 121 110 121 110 121 110 121 110 121 110 121 110 121 110 121 110 121 110 121 110 121 110 121 110 121 110 121 110 121 110 121 110 121 110 121 110 121 110 121 110 121 110 121 110 121 110 121 110 121 110 121 110 121 110 121 110 121 122
122 110 123 110 123 110 123 110 123 110 123 110 123 110 123 110 123 110 123 110 123 110 123 110 123 110 123 110 123 110 123 110 123 110 123 110 123 110 123 110 123 110 123 110 123 110 123 110 123 110 123 110 123 110 123 110 123 110 123 122
122 110 121 110 121 110 121 110 121 110 121 110 121 110 121 110 121 110 121 110 121 110 121 110 121 110 121 110 121 110 121 110 121 110 121 110 121 110 121 110 121 110 121 110 121 110 121 110 121 110 121 110 121 110 121 110 121 110 121 122
122 110 123 110 123 110 123 110 123 110 123 110 123 110 123 110 123 110 123 110 123 110 123 110 123 110 123 110 123 110 123 110 123 110 123 110 123 110 123 110 123 110 123 110 123 110 123 110 123 110 123 110 123 110 123 110 123 110 123 122
122 110 121 110 121 110 121 110 121 110 121 110 121 110 121 110 121 110 121 110 121 110 121 110 121 110 121 110 121 110 121 110 121 110 121 110 121 110 121 110 121 110 121 110 121 110 121 110 121 110 121 110 121 110 121 110 121 110 121 122
122 110 123 110 123 110 123 110 123 110 123 110 123 110 123 110 123 110 123 110 123 110 123 110 123 110 123 110 123 110 123 110 123 110 123 110 123 110 123 110 123 110 123 110 123 110 123 110 123 110 123 110 123 110 123 110 123 110 123 122
122 110 121 110 121 110 121 110 121 110 121 110 121 110 121 110 121 110 121 110 121 110 121 110 121 110 121 110 121 110 121 110 121 110 121 110 121 110 121 110 121 110 121 110 121 110 121 110 121 110 121 110 121 110 121 110 121 110 121 122
122 110 123 110 123 110 123 110 123 110 123 110 123 110 123 110 123 110 123 110 123 110 123 110 123 110 123 110 123 110 123 110 123 110 123 110 123 110 123 110 123 110 123 110 123 110 123 110 123 110 123 110 123 110 123 110 123 110 123 122
122 110 123 110 123 110 123 110 123 110 123 110 123 110 123 110 123 110 123 110 123 110 123 110 123 110 123 110 123 110 123 110 123 110 123 110 123 110 123 110 123 110 123 110 123 110 123 110 123 110 123 110 123 110 123 110 123 110 123 122
122 110 121 110 121 110 121 110 121 110 121 110 121 110 121 110 121 110 121 110 121 110 121 110 121 110 121 110 121 110 121 110 121 110 121 110 121 110 121 110 121 110 121 110 121 110 121 110 121 110 121 110 121 110 121 110 121 110 121 122
122 110 123 110 123 110 123 110 123 110 123 110 123 110 123 110 123 110 123 110 123 110 123 110 123 110 123 110 123 110 123 110 123 110 123 110 123 110 123 110 123 110 123 110 123 110 123 110 123 110 123 110 123 110 123 110 123 110 123 122
122 110 121 110 121 110 121 110 121 110 121 110 121 110 121 110 121 110 121 110 121 110 121 110 121 110 121 110 121 110 121 110 121 110 121 110 121 110 121 110 121 110 121 110 121 110 121 110 121 110 121 110 121 110 121 110 121 110 121 122
122 110 123 110 123 110 123 110 123 110 123 110 123 110 123 110 123 110 123 110 123 110 123 110 123 110 123 110 123 110 123 110 123 110 123 110 123 110 123 110 123 110 123 110 123 110 123 110 123 110 123 110 123 110 123 110 123 110 123 122
122 110 121 110 121 110 121 110 121 110 121 110 121 110 121 110 121 110 121 110 121 110 121 110 121 110 121 110 121 110 121 110 121 110 121 110 121 110 121 110 121 110 121 110 121 110 121 110 121 110 121 110 121 110 121 110 121 110 121 122
122 110 123 110 123 110 123 110 123 110 123 110 123 110 123 110 123 110 123 110 123 110 123 110 123 110 123 110 123 110 123 110 123 110 123 110 123 110 123 110 123 110 123 110 123 110 123 110 123 110 123 110 123 110 123 110 123 110 123 122
122 110 121 110 121 110 121 110 121 110 121 110 121 110 121 110 121 110 121 110 121 110 121 110 121 110 121 110 121 110 121 110 121 110 121 110 121 110 121 110 121 110 121 110 121 110 121 110 121 110 121 110 121 110 121 110 121 110 121 122
122 110 123 110 123 110 123 110 123 110 123 110 123 110 123 110 123 110 123 110 123 110 123 110 123 110 123 110 123 110 123 110 123 110 123 110 123 110 123 110 123 110 123 110 123 110 123 110 123 110 123 110 123 110 123 110 123 110 123 122
122 110 121 110 121 110 121 110 121 110 121 110 121 110 121 110 121 110 121 110 121 110 121 110 121 110 121 110 121 110 121 110 121 110 121 110 121 110 121 110 121 110 121 110 121 110 121 110 121 110 121 110 121 110 121 110 121 110 121 122
122 110 123 110 123 110 123 110 123 110 123 110 123 110 123 110 123 110 123 110 123 110 123 110 123 110 123 110 123 110 123 110 123 110 123 110 123 110 123 110 123 110 123 110 123 110 123 110 123 110 123 110 123 110 123 110 123 110 123 122
122 110 121 110 121 110 121 110 121 110 121 110 121 110 121 110 121 110 121 110 121 110 121 110 121 110 121 110 121 110 121 110 121 110 121 110 121 110 121 110 121 110 121 110 121 110 121 110 121 110 121 110 121 110 121 110 121 110 121 122
122 110 123 110 123 110 123 110 123 110 123 110 123 110 123 110 123 110 123 110 123 110 123 110 123 110 123 110 123 110 123 110 123 110 123 110 123 110 123 110 123 110 123 110 123 110 123 110 123 110 123 110 123 110 123 110 123 110 123 122
122 110 121 110 121 110 121 110 121 110 121 110 121 110 121 110 121 110 121 110 121 110 121 110 121 110 121 110 121 110 121 110 121 110 121 110 121 110 121 110 121 110 121 110 121 110 121 110 121 110 121 110 121 110 121 110 121 110 121 122
122 110 123 110 123 110 123 110 123 110 123 110 123 110 123 110 123 110 123 110 123 110 123 110 123 110 123 110 123 110 123 110 123 110 123 110 123 110 123 110 123 110 123 110 123 110 123 110 123 110 123 110 123 110 123 110 123 110 123 122
122 110 121 110 121 110 121 110 121 110 121 110 121 110 121 110 121 110 121 110 121 110 121 110 121 110 121 110 121 110 121 110 121 110 121 110 121 110 121 110 121 110 121 110 121 110 121 110 121 110 121 110 121 110 121 110 121 110 121 122
122 110 123 110 123 110 123 110 123 110 123 110 123 110 123 110 123 110 123 110 123 110 123 110 123 110 123 110 123 110 123 110 123 110 123 110 123 110 123 110 123 110 123 110 123 110 123 110 123 110 123 110 123 110 123 110 123 110 123 122
122 110 121 110 121 110 121 110 121 110 121 110 121 110 121 110 121 110 121 110 121 110 121 110 121 110 121 110 121 110 121 110 121 110 121 110 121 110 121 110 121 110 121 110 121 110 121 110 121 110 121 110 121 110 121 110 121 110 121 122
122 122 122 122 122 122 122 122 122 122 122 122 122 122 122 122 122 122 122 122 122 122 122 122 122 122 122 122 122 122 122 122 122 122 122 122 122 122 122 122 122 122 122 122 122 122 122 122 122 122 122 122 122 122 122 122 122 122 122 122