43 77 42 43 42 95 96 95 96 95 96 42 43 42 42 43 42 95 96 95 96 77 42 43 77 42 43 12 12 12 12 12 12 12 12 12 12 12 12 12 12 12 12 12 12 12 12 12 12 22 20 20 20 20 20 20 20 20 23 12  
95 96 90 91 92 93 94 93 94 93 94 90 91 92 90 91 92 93 94 93 94 90 91 92 90 91 92 12 12 12 12 12 12 12 12 12 12 12 12 12 12 12 12 12 12 12 12 12 12 18 77 77 72 73 74 75 76 77 17 12  
93 94 87 88 89 90 90 91 92 95 96 87 88 89 87 88 89 95 96 95 96 87 88 89 87 88 89 13 12 12 12 12 12 12 12 13 12 12 12 12 12 12 12 12 12 12 12 12 12 18 43 77 67 68 69 70 71 77 17 12  
77 42 84 85 86 42 87 88 89 93 94 84 85 86 84 85 86 93 94 93 94 84 85 86 84 85 86 12 12 13 12 12 12 12 12 12 12 12 12 12 12 12 12 13 12 12 12 12 12 18 42 41 62 63 64 65 66 77 17 12  
42 77 90 91 92 42 84 85 86 95 96 90 91 92 95 96 90 91 92 90 91 92 90 91 92 41 12 12 12 12 12 12 12 13 12 12 13 12 12 12 13 12 12 12 12 12 12 12 12 18 77 42 57 58 59 60 61 41 17 12  
43 42 87 88 89 95 96 95 96 93 94 87 88 89 93 94 87 88 89 87 88 89 87 88 89 43 12 12 12 12 12 13 12 12 12 12 12 12 13 12 12 12 12 12 12 13 12 12 12 18 43 77 52 53 54 55 56 77 17 12  
41 77 84 85 86 93 94 93 94 77 43 84 85 86 77 77 84 85 86 84 85 86 84 85 86 43 20 20 20 23 12 12 12 22 20 20 20 20 20 20 20 20 20 20 23 12 12 12 12 18 42 43 10 80 10 10 10 43 17 12  
77 42 95 96 95 96 90 91 92 40 40 40 40 40 40 40 95 96 95 96 42 90 91 92 77 77 10 10 10 19 20 20 20 21 41 10 35 33 33 33 33 33 33 36 17 12 12 13 12 18 77 10 10 80 10 11 41 42 17 12  
95 96 93 94 93 94 87 88 89 40 97 97 97 97 97 40 93 94 93 94 43 87 88 89 90 91 92 16 10 10 10 10 10 10 10 10 31 26 26 26 26 26 26 30 17 12 12 12 12 18 10 10 83 81 10 10 10 41 17 12  
93 94 95 96 95 96 84 85 86 40 97 97 98 97 97 40 90 91 92 95 96 84 85 86 87 88 89 18 10 41 41 42 41 41 41 41 31 26 26 26 26 26 26 30 46 46 46 46 46 46 82 82 81 10 10 14 15 15 25 12  
95 96 93 94 93 94 90 91 92 40 97 97 97 97 97 40 87 88 89 93 94 90 91 92 84 85 86 18 11 42 41 41 41 41 41 42 31 26 26 26 26 26 26 30 14 50 50 50 50 16 10 10 11 10 10 17 12 12 12 12  
93 94 42 90 91 92 87 88 89 40 97 97 97 97 97 40 84 85 86 77 42 87 88 89 43 20 20 21 10 41 41 41 41 41 42 41 31 26 26 26 26 26 26 30 17 12 12 12 12 18 10 10 10 95 96 17 12 12 12 12  
77 77 43 87 88 89 84 85 86 40 40 40 97 40 40 40 95 96 95 96 43 84 85 86 77 95 96 10 10 41 41 41 41 41 41 41 37 28 28 29 26 27 28 38 17 13 12 12 12 18 42 43 43 93 94 17 12 12 12 12  
41 77 43 84 85 86 77 95 96 95 96 40 11 40 95 96 93 94 93 94 41 95 96 77 42 93 94 95 96 42 41 90 91 92 41 42 41 41 41 31 26 30 14 15 25 12 12 12 12 24 15 15 15 15 15 25 12 12 12 12  
95 96 95 96 77 95 96 93 94 93 94 77 95 96 93 94 90 91 92 95 96 93 94 95 96 90 91 92 94 43 41 87 88 89 41 41 41 42 41 31 26 30 17 12 12 12 12 13 12 12 12 12 12 12 12 12 12 12 12 12 
93 94 93 94 43 93 94 77 42 77 95 96 93 94 95 96 87 88 89 93 94 41 41 93 94 87 88 89 43 42 42 84 85 86 42 41 41 41 41 31 26 30 17 12 12 12 12 12 12 12 12 12 12 12 12 12 12 12 12 12 
77 77 95 96 77 95 96 90 91 92 93 94 43 42 93 94 84 85 86 42 90 91 92 77 77 84 85 86 10 45 42 41 41 41 41 41 41 41 41 31 26 30 17 12 12 12 12 12 13 12 12 12 12 12 12 12 12 12 12 12  
95 96 93 94 77 93 94 87 88 89 77 42 77 95 96 90 91 92 95 96 87 88 89 95 96 77 30 42 41 41 42 41 41 42 41 41 42 35 33 34 26 30 17 12 12 13 12 12 12 12 12 12 12 12 12 12 12 12 12 12  
93 94 43 77 42 77 41 84 85 86 43 77 77 93 94 87 88 89 93 94 84 85 86 93 94 43 30 41 41 43 41 41 41 41 43 42 42 31 26 26 26 30 17 12 12 12 12 12 12 12 12 12 12 12 12 12 12 12 12 12  
12 12 12 13 12 12 12 18 10 42 10 10 77 84 85 86 77 41 42 41 77 77 77 43 30 10 42 41 41 42 41 41 41 42 42 31 26 27 28 38 17 12 13 12 12 12 12 12 12 12 12 12 12 12 12 12 12 12 12 12
12 12 12 12 12 12 12 18 10 10 10 10 10 35 33 33 33 33 33 33 33 33 34 26 32 33 33 33 33 33 33 33 33 33 33 34 26 30 10 43 17 12 12 12 12 12 12 12 12 12 12 12 12 12 12 12 12 12 12 12
12 12 12 12 12 13 12 18 10 41 10 77 11 31 26 26 26 26 26 26 26 26 26 26 26 26 26 26 26 26 26 26 26 26 26 26 26 30 42 14 25 12 12 12 12 12 12 12 12 12 12 12 12 12 12 12 12 12 12 12
12 12 12 12 12 12 13 18 10 10 10 10 10 37 28 28 28 28 28 28 28 28 29 26 27 28 28 28 28 28 28 28 28 28 28 29 26 30 10 17 12 13 12 12 12 12 12 12 12 12 12 12 12 12 12 12 12 12 12 12
12 12 12 12 12 12 12 24 16 10 77 41 10 41 42 42 41 42 42 43 41 11 31 26 30 10 77 42 41 42 41 77 42 41 41 31 26 30 10 17 12 12 22 20 20 20 23 12 12 12 12 12 12 12 12 12 12 12 12 12
12 12 12 12 12 12 12 12 18 10 41 41 10 41 77 42 42 42 42 42 95 96 31 26 30 41 41 41 42 42 42 41 41 41 41 31 26 30 11 17 12 12 18 43 10 10 17 12 12 12 12 12 12 12 12 12 12 12 12 12
12 12 12 12 12 13 12 22 21 10 41 41 10 10 10 42 42 77 41 42 93 94 31 26 30 41 42 95 96 41 41 77 41 41 43 31 26 30 10 17 12 12 18 10 10 10 17 12 12 12 13 12 12 12 12 12 12 12 12 12
12 12 12 12 12 12 12 18 10 10 77 41 41 41 10 42 42 42 77 42 77 41 31 26 30 41 42 93 94 41 43 41 41 41 43 31 26 30 10 17 12 12 18 10 11 10 17 12 12 12 12 12 12 12 12 12 12 12 12 12
12 12 12 13 12 12 12 18 10 41 95 96 77 41 10 41 43 41 42 42 42 41 31 26 30 41 77 77 41 41 42 41 42 41 42 31 26 30 10 17 12 13 24 15 15 15 25 12 12 12 12 12 12 12 12 12 12 12 12 12
12 12 12 12 12 12 12 18 10 77 93 94 41 43 10 42 42 41 41 41 42 77 31 26 30 41 41 41 41 41 43 77 41 41 43 31 26 30 10 17 12 12 12 12 12 12 12 12 12 12 12 12 12 12 12 12 12 12 12 12
12 12 12 12 12 12 13 18 10 10 10 10 10 10 10 41 42 90 91 92 41 42 31 26 30 41 41 43 42 41 42 41 41 43 41 37 28 38 46 46 46 47 12 12 13 12 12 12 12 12 12 12 12 12 12 12 12 12 12 12
12 12 12 12 12 12 12 18 10 10 11 10 10 10 10 42 42 87 88 89 42 41 31 26 30 41 77 42 41 90 91 92 41 41 77 42 10 42 14 50 50 49 13 12 12 12 12 12 12 12 12 12 12 12 12 12 12 12 12 12
12 12 12 12 12 12 12 24 16 10 10 10 10 10 10 77 42 84 85 86 42 77 31 26 30 42 42 41 41 87 88 89 41 41 41 10 10 10 17 12 12 12 12 12 12 12 12 12 12 12 12 12 12 12 12 12 12 12 12 12
12 12 12 12 12 13 12 12 18 10 10 10 10 11 10 41 41 42 41 42 42 43 31 26 30 41 41 41 41 84 85 86 41 41 41 10 10 10 17 12 12 12 12 12 12 12 13 12 12 12 12 12 12 12 12 12 12 12 12 12
12 12 12 12 12 12 12 12 18 11 11 10 10 10 10 42 42 77 41 41 42 42 31 26 30 41 41 77 43 41 41 42 41 41 41 10 10 11 17 12 12 13 12 12 12 12 12 12 12 12 12 12 12 12 12 12 12 12 12 12
12 12 12 12 12 12 12 12 18 10 10 10 10 10 10 42 43 42 41 41 42 77 31 26 30 43 41 42 41 42 42 41 42 77 41 10 10 10 17 12 12 12 12 12 12 12 12 12 12 12 12 12 12 12 12 12 12 12 12 12
12 12 12 12 13 12 12 22 21 10 90 91 92 43 42 77 42 42 41 42 42 41 37 28 38 41 41 77 41 41 43 43 42 41 41 11 10 10 19 23 12 13 12 12 12 12 12 12 12 12 12 12 12 12 12 12 12 12 12 12
12 12 12 12 12 12 12 18 41 10 87 88 89 41 41 42 42 77 41 10 10 10 10 10 10 10 10 41 41 41 42 42 42 41 10 10 10 10 10 19 23 12 12 12 13 12 12 12 12 12 12 12 12 12 12 12 12 12 12 12
12 12 12 12 12 12 13 18 10 10 84 85 86 42 90 91 92 42 10 10 10 10 10 10 10 10 10 42 42 41 77 42 10 10 10 10 10 10 10 10 19 20 23 12 12 12 12 12 12 12 12 12 12 12 12 12 12 12 12 12  
12 12 12 12 12 12 12 18 10 41 41 42 43 41 87 88 89 41 10 11 10 10 10 10 10 11 10 10 42 41 42 42 10 10 10 42 10 11 10 10 11 10 17 12 12 12 12 12 12 12 12 12 12 12 12 12 12 12 12 12
12 12 12 12 12 12 12 18 10 41 95 96 42 43 84 85 86 41 10 10 10 11 10 10 10 10 10 10 10 42 41 41 10 10 10 10 10 10 10 10 10 77 17 12 12 12 12 12 12 12 12 12 12 12 12 12 12 12 12 12
12 12 13 12 12 12 12 18 10 77 93 94 77 42 10 10 10 10 10 10 10 10 10 10 10 10 10 10 10 10 10 10 10 10 10 10 10 10 10 10 10 10 17 12 12 13 12 12 12 12 12 12 12 12 12 12 12 12 12 12
12 12 12 12 12 12 12 18 10 10 10 10 10 10 10 14 15 15 16 10 10 10 10 10 11 10 10 14 15 15 16 10 10 10 10 10 10 10 11 10 10 10 17 12 12 12 12 13 12 12 12 12 12 12 12 12 12 12 12 12
12 12 12 12 12 12 12 18 41 43 77 42 41 41 14 25 12 12 24 16 10 10 10 10 10 10 14 25 12 12 18 10 10 41 10 10 10 10 41 10 10 10 17 12 12 12 12 12 12 12 12 12 12 12 12 12 12 12 12 12
12 12 12 12 13 12 12 24 15 15 15 15 15 15 25 12 12 12 12 24 15 15 15 15 15 15 25 12 13 12 24 16 10 11 10 10 10 10 10 10 10 10 17 12 12 12 12 12 12 12 12 12 12 12 12 12 12 12 12 12
12 12 12 12 12 12 12 12 12 12 12 12 12 12 12 12 12 12 13 12 12 12 12 12 12 12 12 12 12 12 12 24 15 15 15 15 15 15 15 15 15 15 25 12 12 12 13 12 12 12 12 12 12 12 12 12 12 12 12 12
12 12 12 12 12 12 12 12 12 12 12 13 12 12 12 12 13 12 12 12 12 12 12 12 12 12 12 12 12 12 12 12 12 12 12 12 13 12 12 12 12 12 12 13 12 12 12 12 12 12 12 12 12 12 12 12 12 12 12 12
12 12 12 12 12 12 13 12 12 12 12 12 12 12 12 12 12 12 12 12 12 12 12 12 13 12 12 12 12 13 12 12 12 12 12 12 12 12 12 12 12 12 12 12 12 12 12 12 12 12 12 12 12 12 12 12 12 12 12 12
12 12 12 12 12 12 12 12 12 12 12 12 12 12 13 12 12 12 12 12 13 12 12 12 12 12 12 12 12 12 12 12 13 12 12 12 12 12 12 13 12 12 12 12 12 12 12 12 12 12 12 12 12 12 12 12 12 12 12 12
12 12 12 12 12 12 12 12 12 12 12 12 12 12 12 12 12 12 12 12 12 12 12 12 12 12 12 13 12 12 12 12 12 12 12 12 12 12 12 12 12 12 12 12 12 13 12 12 12 12 12 12 12 12 12 12 12 12 12 12
12 12 12 12 12 12 12 12 12 12 12 12 12 12 12 12 12 12 12 12 12 12 12 12 12 12 12 12 12 12 12 12 12 12 12 12 12 12 12 12 12 12 12 12 12 12 12 12 12 12 12 12 12 12 12 12 12 12 12 12
12 12 12 12 12 12 12 12 12 12 12 12 12 12 12 12 12 12 12 12 12 12 12 12 12 12 12 12 12 12 12 12 12 12 12 12 12 12 12 12 12 12 12 12 12 12 12 12 12 12 12 12 12 12 12 12 12 12 12 12