180 180 180 180 180 180 180 180 180 180 180 180 180 180 180 180 180 180 180 180 180 180 180 180 180 180 180 180 180 180 180 180 180 180 180 180 180 180 180 180 180 180 180 180 180 180 180 180 180 180 180 180 180 180 180 180 180 180 180 180
180 180 180 180 180 180 180 180 180 180 180 180 180 180 180 180 180 180 180 180 180 180 180 180 180 180 180 180 180 180 180 180 180 180 180 180 180 180 180 180 180 180 180 180 180 180 180 180 180 180 180 180 180 180 180 180 180 180 180 180
180 180 180 180 180 180 180 180 180 180 180 180 180 180 180 180 180 180 180 180 180 180 180 180 180 180 180 180 180 180 180 180 180 180 180 180 180 180 180 180 180 180 180 180 180 180 180 180 180 180 180 180 180 180 180 180 180 180 180 180
180 180 180 180 180 180 180 180 180 180 180 180 180 180 180 180 180 180 180 180 180 180 180 180 180 180 180 180 180 180 180 180 180 180 180 180 180 180 180 180 180 180 180 180 180 180 180 180 180 180 180 180 180 180 180 180 180 180 180 180
180 180 180 190 188 188 188 188 188 188 191 180 180 180 180 180 180 190 188 188 188 188 188 188 188 188 188 188 188 188 188 188 188 188 188 188 188 188 188 188 188 188 188 188 188 188 188 188 188 188 188 188 188 191 180 180 180 180 180 180
180 180 190 189 129 129 129 129 129 129 187 188 191 180 180 180 180 186 129 139 129 129 129 129 129 129 139 129 129 124 140 124 140 124 140 124 140 124 140 124 129 129 129 129 129 129 129 129 129 129 129 129 129 184 180 180 180 180 180 180
180 180 186 129 129 129 129 129 129 129 129 139 184 180 180 180 190 189 129 129 139 129 129 129 129 124 129 124 124 124 133 130 130 130 130 130 130 130 130 130 130 129 129 129 129 129 129 129 129 129 129 129 129 187 191 180 180 180 180 180
180 180 186 129 129 129 129 129 129 147 129 129 187 188 188 188 189 129 129 129 129 129 129 139 129 129 129 124 124 124 131 124 124 124 124 124 124 140 124 140 129 129 129 129 129 129 129 129 129 129 129 129 129 129 184 180 180 180 180 180
180 180 192 182 183 129 129 129 129 129 129 129 129 129 129 129 129 129 129 139 129 139 129 129 129 129 124 124 124 124 131 127 128 124 124 124 129 129 129 129 129 129 129 129 129 129 129 129 129 129 129 129 129 129 187 191 180 180 180 180
180 180 180 180 186 129 129 129 129 129 129 129 129 129 127 128 124 140 129 129 129 129 129 147 129 129 129 124 127 128 131 125 126 127 128 124 129 124 129 129 129 129 129 129 129 129 129 129 129 129 129 129 129 129 129 184 180 180 180 180
180 180 180 180 192 182 183 129 129 129 139 129 147 129 125 126 140 124 129 129 129 139 129 129 129 124 124 124 125 126 131 127 128 125 126 127 128 129 129 129 129 129 129 129 129 129 129 129 129 129 129 129 129 129 129 184 180 180 180 180 
180 180 180 180 180 180 186 129 129 129 129 129 129 129 124 129 140 124 129 139 129 129 129 129 129 124 124 124 124 124 131 125 126 127 128 125 126 129 129 129 129 129 129 129 129 129 129 129 129 129 129 129 129 129 129 184 180 180 180 180
180 180 180 180 180 180 186 129 129 129 129 129 129 129 140 140 129 124 129 129 139 129 129 129 129 129 124 127 128 124 131 127 128 125 126 129 129 129 129 129 129 129 129 129 129 129 129 129 129 129 129 129 129 129 129 184 180 180 180 180
180 180 180 180 180 180 186 129 129 129 129 129 129 124 127 128 140 140 129 129 129 129 139 129 129 139 124 125 126 124 131 125 126 124 127 128 139 129 129 129 129 129 124 139 124 147 124 129 129 129 129 129 129 129 129 184 180 180 180 180
180 180 180 180 180 180 186 129 129 129 140 124 124 124 125 126 127 128 140 124 129 129 129 129 129 129 124 124 124 124 131 124 124 124 125 126 124 129 129 129 129 129 129 140 140 124 124 129 129 129 129 129 129 129 129 184 180 180 180 180
180 180 180 180 180 180 186 129 147 129 124 127 128 145 146 139 125 126 140 124 129 147 129 124 129 129 124 124 124 124 131 127 128 124 124 124 129 129 129 129 129 129 140 157 158 159 124 139 129 129 129 129 129 129 181 193 180 180 180 180
180 180 180 180 180 180 186 129 129 129 140 125 126 143 144 145 146 127 128 140 129 129 129 129 129 129 124 124 124 124 131 125 126 127 128 124 124 129 129 129 129 129 139 154 155 156 140 129 129 129 129 129 129 129 184 180 180 180 180 180
180 180 180 180 180 180 192 183 129 129 124 127 128 141 142 143 144 125 126 124 129 129 129 129 129 129 129 124 127 128 131 127 128 125 126 127 128 139 129 129 129 129 124 151 152 153 124 129 129 129 129 129 129 129 184 180 180 180 180 180
180 180 180 180 180 180 180 186 129 129 140 125 126 127 128 141 142 124 140 129 129 139 129 129 139 129 129 124 125 126 131 125 126 124 124 125 126 124 129 129 129 129 124 147 129 140 139 129 129 129 129 129 129 129 184 180 180 180 180 180
180 180 180 180 180 180 180 186 129 129 124 140 124 125 126 124 127 128 140 129 139 129 129 124 129 129 129 124 124 124 129 124 124 124 124 124 124 129 129 129 129 129 129 129 129 124 129 129 129 129 129 129 129 129 184 180 180 180 180 180
180 180 180 180 180 180 180 186 129 129 140 124 145 146 145 146 125 126 124 129 129 129 129 129 129 129 124 129 129 129 129 139 129 129 129 129 129 129 129 129 129 129 129 129 129 129 129 129 129 129 129 129 129 129 184 180 180 180 180 180
180 180 180 180 180 190 188 189 129 129 129 140 143 144 143 144 124 124 140 129 129 139 129 129 147 129 129 139 129 129 129 124 129 139 129 124 129 129 129 129 129 129 129 129 129 129 129 129 129 129 129 129 129 181 193 180 180 180 180 180
180 180 180 180 180 186 129 129 129 129 129 129 141 142 141 142 124 140 129 129 139 129 129 129 129 129 129 127 128 139 129 129 129 129 129 129 129 129 129 129 129 129 129 129 129 129 129 129 129 129 129 129 129 184 180 180 180 180 180 180
180 180 180 180 180 186 129 129 129 129 129 129 147 129 129 129 140 124 129 129 129 139 129 129 139 129 129 125 126 129 129 129 129 129 124 129 129 129 129 129 129 129 129 129 129 129 129 129 129 129 129 129 129 184 180 180 180 180 180 180
180 180 180 180 180 186 129 147 129 129 129 129 129 129 139 129 129 139 129 129 129 129 129 129 129 129 139 129 129 129 129 129 129 129 129 129 129 129 129 129 129 129 129 129 129 129 129 129 129 129 129 129 129 187 191 180 180 180 180 180
180 180 180 180 180 186 129 129 139 129 129 129 129 129 129 129 139 129 129 129 147 129 129 129 129 129 129 129 129 129 129 129 129 129 129 129 129 129 129 129 129 129 129 129 129 129 129 129 129 129 129 129 129 129 184 180 180 180 180 180
180 180 180 180 180 186 129 129 129 129 129 129 129 129 129 129 129 129 139 129 129 129 129 129 129 129 139 129 129 129 129 129 129 129 129 129 129 129 129 129 129 129 129 129 129 129 129 129 129 129 129 129 129 129 184 180 180 180 180 180
180 180 180 180 180 186 129 129 129 129 129 129 129 139 139 129 129 129 129 129 129 139 129 129 129 129 129 129 129 139 129 129 129 129 129 129 129 129 129 129 129 129 129 129 129 129 129 129 129 129 129 129 129 181 193 180 180 180 180 180
180 180 180 180 180 192 183 129 129 129 129 129 129 129 129 129 129 147 129 129 129 129 129 129 129 129 129 129 129 129 129 129 129 129 129 129 129 129 129 129 129 129 129 129 129 129 129 129 129 129 129 129 129 184 180 180 180 180 180 180
180 180 180 180 180 180 192 183 129 129 129 129 147 129 129 129 139 129 139 129 129 129 129 129 129 129 129 129 129 139 129 129 129 129 129 129 129 129 129 129 129 129 129 129 129 129 129 129 129 129 129 129 129 184 180 180 180 180 180 180
180 180 180 180 180 180 180 186 129 129 129 129 129 129 129 129 129 129 129 129 129 129 129 129 129 129 129 129 129 129 129 129 129 129 129 129 129 129 129 129 129 129 129 129 129 129 129 129 129 129 129 129 129 184 180 180 180 180 180 180
180 180 180 180 180 180 180 192 183 129 129 129 129 129 129 129 129 129 129 129 129 129 129 129 129 129 129 129 129 129 129 129 129 129 129 129 129 129 129 129 129 129 129 129 129 129 129 129 129 129 129 129 129 184 180 180 180 180 180 180
180 180 180 180 180 180 180 180 186 129 129 129 129 129 139 129 129 129 129 129 129 129 129 129 129 129 129 129 129 129 129 129 129 129 129 129 129 129 129 129 129 129 129 129 129 129 129 129 129 129 129 129 181 193 180 180 180 180 180 180
180 180 180 180 180 180 180 180 186 129 129 129 129 129 129 129 129 129 129 129 129 129 129 129 129 129 129 129 129 129 129 129 129 129 129 129 129 129 129 129 129 129 129 129 129 129 129 129 129 129 129 129 184 180 180 180 180 180 180 180
180 180 180 180 180 180 180 180 186 129 129 129 129 129 129 129 129 129 129 129 129 129 129 129 129 129 129 129 129 129 129 129 129 129 129 129 129 129 129 129 129 129 129 129 129 129 129 129 129 129 129 129 184 180 180 180 180 180 180 180
180 180 180 180 180 180 180 190 189 129 129 129 129 129 129 129 129 129 129 129 129 129 129 129 129 129 129 129 129 129 129 129 129 129 129 129 129 129 129 129 129 129 129 129 129 129 129 129 129 129 129 129 184 180 180 180 180 180 180 180
180 180 180 180 180 180 190 189 129 129 129 129 129 129 129 129 129 129 129 129 129 129 129 129 129 129 129 129 129 129 129 129 129 129 129 129 129 129 129 129 129 129 129 129 129 129 129 129 129 129 129 129 184 180 180 180 180 180 180 180
180 180 180 180 180 180 186 129 129 129 129 129 129 129 129 129 129 129 129 129 129 129 129 129 129 129 129 129 129 129 129 129 129 129 129 129 129 129 129 129 129 129 129 129 129 129 129 129 129 129 129 129 184 180 180 180 180 180 180 180
180 180 180 180 180 180 186 129 129 129 129 129 129 129 129 129 129 129 129 129 129 129 129 129 129 129 129 129 129 129 129 129 129 129 129 129 129 129 129 129 129 129 129 129 129 129 129 129 129 129 129 129 187 191 180 180 180 180 180 180
180 180 180 180 180 180 192 183 129 129 129 129 129 129 129 129 129 129 129 129 129 129 129 129 129 129 129 129 129 129 129 129 129 129 129 129 129 129 129 129 129 129 129 129 129 129 129 129 129 129 129 129 129 184 180 180 180 180 180 180
180 180 180 180 180 180 180 192 183 129 129 129 129 129 139 129 129 129 129 129 129 129 129 129 129 129 129 129 129 129 129 129 129 129 129 129 129 129 129 129 129 129 129 129 129 129 129 129 129 129 129 129 129 184 180 180 180 180 180 180
180 180 180 180 180 180 180 180 186 129 129 129 129 129 129 129 129 129 129 129 129 129 129 129 129 129 129 129 129 129 129 129 129 129 129 129 129 129 129 129 129 129 129 129 129 129 129 129 129 129 129 181 182 193 180 180 180 180 180 180
180 180 180 180 180 180 180 180 186 129 129 129 129 129 129 129 129 129 129 129 129 129 129 129 129 129 129 129 129 129 129 129 129 129 129 129 129 129 129 129 129 129 129 129 129 129 129 129 129 129 129 184 180 180 180 180 180 180 180 180
180 180 180 180 180 180 180 180 186 129 129 129 129 129 129 129 129 129 129 129 129 129 129 129 129 129 129 129 129 129 129 129 129 129 129 129 129 129 129 129 129 129 129 129 129 129 129 129 129 181 182 193 180 180 180 180 180 180 180 180
180 180 180 180 180 180 180 190 189 129 129 129 129 129 129 129 129 129 129 129 129 129 129 129 129 129 129 129 129 129 129 129 129 129 129 129 129 129 129 129 129 129 129 129 129 129 129 129 129 184 180 180 180 180 180 180 180 180 180 180
180 180 180 180 180 180 180 186 129 129 129 129 129 129 129 129 129 129 129 129 129 129 129 129 129 129 129 129 129 129 129 129 129 129 129 129 129 129 129 129 129 129 129 129 129 129 129 129 129 184 180 180 180 180 180 180 180 180 180 180
180 180 180 180 180 180 190 189 129 129 129 129 129 129 129 129 129 129 129 129 129 129 129 129 129 129 129 129 129 129 129 129 129 129 129 129 129 129 129 129 129 129 129 129 129 129 129 129 129 187 188 191 180 180 180 180 180 180 180 180
180 180 180 180 180 180 186 129 129 129 129 129 129 129 129 129 129 129 129 129 129 129 129 129 129 129 129 129 129 129 129 129 129 129 129 129 129 129 129 129 129 129 129 129 129 129 129 129 129 129 129 187 188 191 180 180 180 180 180 180
180 180 180 180 180 180 186 129 129 129 129 129 129 129 139 129 129 129 129 129 129 129 129 129 129 129 129 129 129 129 129 129 129 129 129 129 129 129 129 129 129 129 129 129 129 129 129 129 129 129 129 129 129 184 180 180 180 180 180 180
180 180 180 180 180 180 192 183 129 129 129 129 129 129 129 129 129 129 129 129 129 129 129 129 129 129 129 129 129 129 129 129 129 129 129 129 129 129 129 129 129 129 129 129 129 129 129 129 129 129 129 129 129 184 180 180 180 180 180 180
180 180 180 180 180 180 180 192 183 129 129 129 129 129 129 129 129 129 129 129 129 129 129 129 129 129 129 129 129 129 129 129 129 129 129 129 129 129 129 129 129 129 129 129 129 129 129 129 129 129 129 129 129 184 180 180 180 180 180 180
180 180 180 180 180 180 180 180 186 129 129 129 129 129 129 129 129 129 129 129 129 129 129 129 129 129 129 129 129 129 129 129 129 129 129 129 129 129 129 129 129 129 129 129 129 129 129 129 129 129 129 129 129 184 180 180 180 180 180 180
180 180 180 180 180 180 180 180 186 129 129 129 129 129 129 129 129 129 129 129 129 129 129 129 129 129 129 129 129 129 129 129 129 129 129 129 129 129 129 129 129 129 129 129 129 129 129 129 129 129 129 129 181 193 180 180 180 180 180 180
180 180 180 180 180 180 180 180 186 129 129 129 129 129 129 129 129 129 129 129 129 129 129 129 129 129 129 129 129 129 129 129 129 129 129 129 129 129 129 129 129 129 129 129 129 129 129 129 129 129 181 182 193 180 180 180 180 180 180 180
180 180 180 180 180 180 180 180 192 182 182 182 182 182 182 182 182 182 182 182 182 182 182 182 182 182 182 182 182 182 182 182 182 182 182 182 182 182 182 182 182 182 182 182 182 182 182 182 182 182 193 180 180 180 180 180 180 180 180 180
180 180 180 180 180 180 180 180 180 180 180 180 180 180 180 180 180 180 180 180 180 180 180 180 180 180 180 180 180 180 180 180 180 180 180 180 180 180 180 180 180 180 180 180 180 180 180 180 180 180 180 180 180 180 180 180 180 180 180 180
180 180 180 180 180 180 180 180 180 180 180 180 180 180 180 180 180 180 180 180 180 180 180 180 180 180 180 180 180 180 180 180 180 180 180 180 180 180 180 180 180 180 180 180 180 180 180 180 180 180 180 180 180 180 180 180 180 180 180 180
180 180 180 180 180 180 180 180 180 180 180 180 180 180 180 180 180 180 180 180 180 180 180 180 180 180 180 180 180 180 180 180 180 180 180 180 180 180 180 180 180 180 180 180 180 180 180 180 180 180 180 180 180 180 180 180 180 180 180 180
180 180 180 180 180 180 180 180 180 180 180 180 180 180 180 180 180 180 180 180 180 180 180 180 180 180 180 180 180 180 180 180 180 180 180 180 180 180 180 180 180 180 180 180 180 180 180 180 180 180 180 180 180 180 180 180 180 180 180 180
180 180 180 180 180 180 180 180 180 180 180 180 180 180 180 180 180 180 180 180 180 180 180 180 180 180 180 180 180 180 180 180 180 180 180 180 180 180 180 180 180 180 180 180 180 180 180 180 180 180 180 180 180 180 180 180 180 180 180 180
